17 18 19 19 19 16 16 16 19 19 19 19 16 18 17 31 38 7 7 7 7 39 16 16 19 19 31 16 16 16 38 7 7 7 7 7 7 7 39 17 18 14 7 7 7 7 39 26 26 26 31 18 23 16 16 38 7 7 7 7 7 7 7 15 2 -1 32 19 19 19 19 19 19 19 16 17 19 19 19 19 19 38 7 7 7 7 7 7 7 7 7 7 7 7 7 7 7 7 7 7 7
21 16 16 16 14 7 7 7 39 17 16 19 24 23 31 38 45 -1 -1 -1 -1 46 7 15 2 -1 16 38 7 7 7 45 -1 -1 -1 -1 -1 -1 -1 46 7 7 9 -1 -1 -1 -1 46 39 16 16 38 7 7 7 7 45 -1 -1 -1 -1 -1 -1 -1 8 7 39 19 19 19 19 19 19 24 18 23 17 19 19 19 38 45 -1 -1 -1 -1 -1 -1 -1 -1 -1 -1 -1 -1 -1 -1 -1 -1 -1 -1 -1
19 18 7 7 9 -1 -1 -1 46 7 7 7 39 16 18 45 -1 -1 -1 -1 -1 -1 -1 8 7 7 45 -1 -1 -1 -1 -1 -1 -1 -1 -1 -1 -1 -1 -1 -1 -1 -1 -1 -1 -1 -1 46 7 7 45 -1 -1 -1 -1 -1 -1 -1 -1 -1 -1 -1 -1 -1 -1 46 39 16 16 32 19 21 23 22 19 18 17 31 38 45 -1 -1 -1 -1 -1 -1 -1 -1 -1 -1 -1 -1 -1 -1 -1 -1 -1 -1 -1 -1
18 45 -1 -1 -1 -1 -1 -1 -1 -1 -1 -1 46 7 45 -1 -1 -1 -1 -1 -1 -1 -1 -1 -1 -1 -1 -1 -1 -1 -1 -1 -1 -1 -1 -1 -1 -1 -1 -1 -1 -1 -1 -1 -1 -1 -1 -1 -1 -1 -1 -1 -1 -1 -1 -1 -1 -1 -1 -1 -1 -1 -1 -1 -1 -1 46 7 7 39 16 16 16 16 16 16 16 38 45 -1 -1 -1 -1 -1 -1 -1 -1 -1 -1 -1 -1 -1 -1 -1 -1 -1 -1 -1 -1 -1
45 -1 -1 -1 -1 -1 -1 -1 -1 -1 -1 -1 -1 -1 -1 -1 -1 -1 -1 -1 -1 -1 -1 -1 -1 -1 -1 -1 -1 -1 -1 -1 -1 -1 -1 -1 -1 -1 -1 -1 -1 -1 -1 -1 -1 -1 -1 -1 -1 -1 -1 -1 -1 -1 -1 -1 -1 -1 -1 -1 -1 -1 -1 -1 -1 -1 -1 -1 -1 46 7 7 7 7 7 7 7 45 -1 -1 -1 -1 -1 -1 -1 -1 -1 -1 -1 -1 -1 -1 -1 -1 -1 -1 -1 -1 -1 -1
-1 -1 -1 -1 -1 -1 -1 -1 -1 -1 -1 -1 -1 -1 -1 -1 -1 -1 -1 -1 -1 -1 -1 -1 -1 -1 -1 -1 -1 -1 -1 -1 -1 34 35 35 35 33 -1 -1 -1 -1 -1 -1 -1 -1 -1 -1 -1 -1 -1 -1 -1 -1 -1 -1 -1 -1 -1 -1 -1 -1 -1 -1 -1 -1 -1 -1 -1 -1 -1 -1 -1 -1 -1 -1 -1 -1 -1 -1 -1 -1 -1 -1 -1 -1 -1 -1 -1 -1 -1 -1 -1 -1 -1 -1 -1 -1 -1 -1
-1 -1 -1 -1 -1 -1 -1 -1 -1 -1 -1 -1 -1 -1 -1 -1 -1 -1 -1 -1 -1 -1 -1 -1 -1 -1 -1 -1 -1 -1 -1 -1 34 41 22 22 24 4 -1 35 35 35 35 33 -1 -1 -1 -1 -1 -1 -1 -1 -1 -1 -1 -1 -1 -1 -1 -1 -1 -1 -1 -1 -1 -1 -1 -1 -1 -1 -1 -1 -1 -1 -1 -1 -1 -1 -1 -1 -1 -1 -1 -1 -1 -1 -1 -1 -1 -1 -1 -1 -1 -1 -1 -1 -1 -1 -1 -1 -1
-1 -1 -1 -1 -1 -1 -1 -1 -1 -1 -1 -1 -1 -1 -1 -1 -1 -1 -1 -1 -1 -1 -1 -1 34 35 35 35 37 -1 -1 34 41 48 19 18 18 47 22 22 22 24 4 -1 35 35 33 -1 -1 -1 -1 -1 -1 -1 -1 -1 -1 -1 -1 -1 -1 -1 -1 -1 -1 -1 -1 -1 -1 -1 -1 -1 -1 -1 -1 -1 -1 -1 -1 -1 -1 -1 -1 -1 -1 -1 -1 -1 -1 -1 -1 -1 -1 -1 -1 -1 -1 -1 -1 -1 -1
-1 -1 -1 -1 -1 -1 -1 -1 -1 -1 -1 -1 -1 -1 -1 -1 -1 -1 -1 -1 -1 -1 -1 34 41 23 22 24 12 35 35 41 48 16 23 19 17 17 16 17 18 22 47 22 24 4 -1 35 35 35 33 -1 -1 -1 -1 -1 -1 -1 -1 -1 -1 -1 -1 -1 -1 -1 -1 -1 -1 -1 34 35 35 35 35 35 35 35 35 33 -1 -1 -1 -1 -1 -1 -1 -1 -1 -1 -1 -1 -1 -1 -1 -1 -1 -1 -1 -1 -1
-1 -1 -1 34 35 35 35 37 -1 -1 -1 -1 -1 -1 -1 -1 -1 -1 -1 36 35 35 35 41 23 19 16 19 24 22 22 24 18 17 19 21 23 19 24 17 19 2 -1 19 24 19 47 22 22 24 4 -1 33 -1 -1 -1 -1 -1 -1 -1 -1 -1 -1 -1 -1 -1 -1 -1 -1 37 35 41 22 22 22 22 22 22 22 24 4 -1 33 -1 -1 -1 -1 -1 -1 -1 -1 -1 -1 -1 -1 -1 -1 -1 -1 -1 -1 -1 -1
35 35 35 41 22 22 22 12 35 35 35 33 -1 -1 -1 -1 34 35 35 13 23 22 22 22 19 19 17 22 19 19 16 22 21 16 16 23 17 19 22 24 19 16 19 21 17 21 17 19 19 47 4 -1 35 35 35 33 -1 -1 -1 -1 -1 -1 -1 -1 34 35 35 35 13 23 19 19 19 18 16 17 19 19 19 47 4 -1 33 -1 -1 -1 -1 -1 -1 -1 -1 -1 -1 -1 -1 -1 -1 -1 -1 -1 -1 -1
22 22 22 48 19 19 19 22 22 22 19 4 -1 35 35 35 35 41 23 22 22 19 19 16 24 17 16 23 19 19 19 19 19 18 21 22 19 22 18 19 21 22 19 2 -1 19 17 23 19 19 19 19 47 22 22 22 4 -1 35 35 35 35 35 35 35 35 13 23 22 22 22 19 21 16 19 2 -1 24 23 19 19 19 19 47 4 -1 35 35 35 35 35 35 35 35 35 35 35 35 35 35 35 35 35 35 35
