19  19  19  19  19  19  19  19  19  19  19  19  19  19  19  19  19  19  19  19
19  19  19  19  19  19  19  19  19  19  19  19  19  19  19  19  19  19  19  19
19  16  16  16  16  16  16  16  16  16  16  16  16  16  16  16  16  16  16  19
21  14  7  7  7  7  7  7  7  7  7  7  7  7  7  7  7  7  15  20
21  11  -1  -1  -1  -1  -1  -1  -1  -1  -1  -1  -1  -1  -1  -1  -1  -1  10  20
21  11  -1  -1  -1  -1  -1  -1  -1  -1  -1  -1  -1  -1  -1  -1  -1  -1  10  20
21  12  37  -1  -1  -1  -1  -1  -1  -1  -1  -1  -1  -1  -1  -1  -1  37  13  20
19  24  12  37  -1  -1  -1  -1  -1  -1  -1  -1  -1  -1  -1  -1  37  13  23  19
19  19  24  12  37  -1  -1  -1  -1  -1  -1  -1  -1  -1  -1  37  13  23  19  19
19  19  19  24  12  37  -1  -1  -1  -1  -1  -1  -1  -1  37  13  23  19  19  19
19  19  19  19  24  12  35  35  35  35  35  35  35  35  13  23  19  19  19  19
19  19  19  19  19  22  22  22  22  22  22  22  22  22  22  19  19  19  19  19
