19 19 19 19 19 19 19 19 38 7
19 19 14 7 7 39 19 38 45 19
38 7 9 19 19 46 7 45 19 19
45 19 19 19 19 19 19 19 19 19
19 19 19 19 19 19 19 19 19 19
19 19 19 19 42 43 43 44 19 19
19 19 19 19 19 19 19 19 19 19
35 35 37 19 19 19 19 34 35 35
22 22 12 35 35 35 35 41 19 19
19 19 47 22 22 22 22 48 19 19
